########
#..#..o#
#.#..###
#.##...#
##...#.#
#@.#...#
########
