########
#..#..@#
#.##..##
#......#
#.##.#.#
#o....##
########
